00000000000000000000000000000000
00g0gg0g00000000000000000000gg00
bbbbbbbb0000000000000000000bbbbb
0000000b0000000000000000000b0000
0000000b0000000000000000000b0000
0000000b0000000000000000000b0000
0000000bg000000000000000000b0000
0000000bbbb0000000000000000b0000
0000000000bg0000000000000bbb0000
0000000000bb000000000000gb000000
00000000000bbb000000000bbb000000
0000000000000bg00000000b00000000
0000000000000bbb00000bbb00000000
000000000000000b0000gb0000000000
000000000000000b000bbb0000000000
000000000000000bggbb000000000000
000000000000000bbbb0000000000000
